44,44,44,44,44,44,44,44,44,44,44,44,44,44,44,44,44,44,
44,44,44,44,44,44,44,44,44,44,44,44,44,44,44,44,44,44,
44,44,44,44,44,44,44,44,44,44,44,44,44,44,44,44,44,44,
44,44,44,44,44,44,44,44,44,44,44,44,44,44,44,44,44,44,
44,44,44,44,44,44,44,44,44,44,44,44,44,44,44,44,44,44,
44,44,44,44,44,44,44,44,44,44,44,44,44,44,44,44,44,44,
44,44,44,44,44,44,44,44,44,44,104,104,104,44,44,44,44,44,
44,44,44,44,44,44,44,104,104,104,153,153,153,104,104,44,44,44,
44,44,44,44,104,104,104,153,153,153,153,153,153,153,153,104,104,44,
104,104,104,104,153,153,153,153,153,153,153,153,153,153,153,153,153,104
